24 HD => Digiturk: - | Belgeselsemo: 24hd
24 TV => Digiturk: 24tv | Belgeselsemo: -
360 => Digiturk: 360 | Belgeselsemo: -
360 HD => Digiturk: - | Belgeselsemo: 360hd
A HABER HD => Digiturk: - | Belgeselsemo: ahaberhd
A NEWS => Digiturk: anews | Belgeselsemo: -
A NEWS HD => Digiturk: - | Belgeselsemo: anewshd
A PARA => Digiturk: apara | Belgeselsemo: -
A PARA HD => Digiturk: - | Belgeselsemo: aparahd
A SPOR => Digiturk: aspor | Belgeselsemo: -
A SPOR HD => Digiturk: - | Belgeselsemo: asporhd
A2 => Digiturk: a2 | Belgeselsemo: -
A2 HD => Digiturk: - | Belgeselsemo: a2hd
AHABER => Digiturk: ahaber | Belgeselsemo: -
AKİT TV => Digiturk: akittv | Belgeselsemo: -
AKİT TV HD => Digiturk: - | Belgeselsemo: akittvhd
AL JAZEERA ARABIC HD => Digiturk: - | Belgeselsemo: aljazeeraarabichd
AL JAZEERA CHANNEL => Digiturk: aljazeerachannel | Belgeselsemo: -
AL JAZEERA ENGLISH => Digiturk: - | Belgeselsemo: aljazeeraenglish
AL JAZEERA INTERNATIONAL => Digiturk: aljazeerainternational | Belgeselsemo: -
AS TV => Digiturk: - | Belgeselsemo: astv
ATV => Digiturk: atv | Belgeselsemo: -
ATV HD => Digiturk: - | Belgeselsemo: atvhd
BABY TV => Digiturk: babytv | Belgeselsemo: -
BABYTV => Digiturk: - | Belgeselsemo: babytv
BBC EARTH => Digiturk: bbcearth | Belgeselsemo: -
BBC ENTERTAINMENT => Digiturk: bbcentertainment | Belgeselsemo: -
BBC FIRST => Digiturk: bbcfirst | Belgeselsemo: -
BBC News => Digiturk: - | Belgeselsemo: bbcnews
BBC WORLD NEWS => Digiturk: bbcworldnews | Belgeselsemo: -
BENGÜTÜRK => Digiturk: benguturk | Belgeselsemo: benguturk
BEYAZ TV => Digiturk: beyaztv | Belgeselsemo: -
BEYAZ TV HD => Digiturk: - | Belgeselsemo: beyaztvhd
BLOOMBERG => Digiturk: bloomberg | Belgeselsemo: -
BLOOMBERG HT => Digiturk: bloomberght | Belgeselsemo: -
BLOOMBERG HT HD => Digiturk: - | Belgeselsemo: bloomberghthd
BOOMERANG HD => Digiturk: boomeranghd | Belgeselsemo: -
BRT 1 => Digiturk: brt1 | Belgeselsemo: -
BRT 1 HD => Digiturk: - | Belgeselsemo: brt1hd
BRT 2 => Digiturk: brt2 | Belgeselsemo: -
BRT 2 HD => Digiturk: - | Belgeselsemo: brt2hd
Bloomberg => Digiturk: - | Belgeselsemo: bloomberg
BluTV Play 1 => Digiturk: - | Belgeselsemo: blutvplay1
BluTV Play 2 => Digiturk: - | Belgeselsemo: blutvplay2
BİZİM EV TV => Digiturk: - | Belgeselsemo: bizimevtv
CADDE TV => Digiturk: caddetv | Belgeselsemo: -
CARTOON NETWORK => Digiturk: cartoonnetwork | Belgeselsemo: cartoonnetwork
CARTOONITO => Digiturk: - | Belgeselsemo: cartoonito
CBeebies => Digiturk: cbeebies | Belgeselsemo: -
CGTN => Digiturk: cgtn | Belgeselsemo: -
CGTN DOCUMENTARY => Digiturk: cgtndocumentary | Belgeselsemo: -
CNBC-E => Digiturk: - | Belgeselsemo: cnbce
CNBC-e => Digiturk: cnbce | Belgeselsemo: -
CNN INTERNATIONAL => Digiturk: cnninternational | Belgeselsemo: -
CNN International => Digiturk: - | Belgeselsemo: cnninternational
CNN TURK => Digiturk: cnnturk | Belgeselsemo: -
CNN TÜRK HD => Digiturk: - | Belgeselsemo: cnnturkhd
DA VINCI HD => Digiturk: - | Belgeselsemo: davincihd
DEUTSCHE WELLE ENGLISH => Digiturk: - | Belgeselsemo: deutschewelleenglish
DISCOVERY CHANNEL => Digiturk: discoverychannel | Belgeselsemo: -
DISCOVERY CHANNEL HD => Digiturk: - | Belgeselsemo: discoverychannelhd
DISCOVERY SCIENCE => Digiturk: discoveryscience | Belgeselsemo: -
DISNEY JUNIOR => Digiturk: disneyjunior | Belgeselsemo: disneyjunior
DMAX => Digiturk: dmax | Belgeselsemo: -
DMAX HD => Digiturk: - | Belgeselsemo: dmaxhd
DREAM TÜRK => Digiturk: - | Belgeselsemo: dreamturk
DUCK TV HD => Digiturk: - | Belgeselsemo: ducktvhd
Da Vinci => Digiturk: davinci | Belgeselsemo: -
DİYANET TV => Digiturk: diyanettv | Belgeselsemo: diyanettv
EKOL TV => Digiturk: ekoltv | Belgeselsemo: ekoltv
EKOTURK => Digiturk: ekoturk | Belgeselsemo: -
EKOTÜRK HD => Digiturk: - | Belgeselsemo: ekoturkhd
EMAX => Digiturk: emax | Belgeselsemo: -
ENGLISH CLUB TV => Digiturk: - | Belgeselsemo: englishclubtv
EPIC DRAMA => Digiturk: - | Belgeselsemo: epicdrama
EURONEWS => Digiturk: euronews | Belgeselsemo: euronews
EUROSPORT 1 => Digiturk: eurosport1 | Belgeselsemo: -
EUROSPORT 1 HD => Digiturk: - | Belgeselsemo: eurosport1hd
EUROSPORT 2 => Digiturk: eurosport2 | Belgeselsemo: -
EUROSPORT 2 HD => Digiturk: - | Belgeselsemo: eurosport2hd
FASHION TV => Digiturk: fashiontv | Belgeselsemo: -
FB TV => Digiturk: fbtv | Belgeselsemo: fbtv
FLASH HABER => Digiturk: flashhaber | Belgeselsemo: flashhaber
FM TV => Digiturk: - | Belgeselsemo: fmtv
FOX => Digiturk: fox | Belgeselsemo: -
FRANCE 24 => Digiturk: france24 | Belgeselsemo: -
FRANCE 24 ARABIC => Digiturk: - | Belgeselsemo: france24arabic
FRANCE 24 ENGLISH => Digiturk: - | Belgeselsemo: france24english
FX HD => Digiturk: - | Belgeselsemo: fxhd
GS TV => Digiturk: gstv | Belgeselsemo: -
GZT => Digiturk: gzt | Belgeselsemo: -
GZT TV => Digiturk: - | Belgeselsemo: gzttv
HABER GLOBAL HD => Digiturk: - | Belgeselsemo: haberglobalhd
HABERGLOBAL => Digiturk: haberglobal | Belgeselsemo: -
HABERTURK => Digiturk: haberturk | Belgeselsemo: -
HABERTÜRK HD => Digiturk: - | Belgeselsemo: haberturkhd
HALK TV => Digiturk: halktv | Belgeselsemo: halktv
HT SPOR => Digiturk: htspor | Belgeselsemo: htspor
KADIRGA TV => Digiturk: - | Belgeselsemo: kadirgatv
KANAL 23 => Digiturk: - | Belgeselsemo: kanal23
KANAL 26 => Digiturk: - | Belgeselsemo: kanal26
KANAL 33 => Digiturk: - | Belgeselsemo: kanal33
KANAL 7 => Digiturk: kanal7 | Belgeselsemo: -
KANAL 7 HD => Digiturk: - | Belgeselsemo: kanal7hd
KANAL D => Digiturk: kanald | Belgeselsemo: -
KANAL D HD => Digiturk: - | Belgeselsemo: kanaldhd
KANAL T => Digiturk: - | Belgeselsemo: kanalt
KANAL V => Digiturk: - | Belgeselsemo: kanalv
KIBRIS ADA TV => Digiturk: - | Belgeselsemo: kibrisadatv
KIBRIS GENC TV => Digiturk: - | Belgeselsemo: kibrisgenctv
KIBRIS TV => Digiturk: - | Belgeselsemo: kibristv
KONTV HD => Digiturk: - | Belgeselsemo: kontvhd
KRT TV => Digiturk: krttv | Belgeselsemo: krttv
LOVE NATURE HD => Digiturk: - | Belgeselsemo: lovenaturehd
LİDER HABER TV => Digiturk: liderhabertv | Belgeselsemo: -
MCM TOP => Digiturk: mcmtop | Belgeselsemo: -
MELTEM TV => Digiturk: - | Belgeselsemo: meltemtv
MEZZO => Digiturk: mezzo | Belgeselsemo: -
MOONBUG KIDS TV => Digiturk: - | Belgeselsemo: moonbugkidstv
MTV 00s => Digiturk: mtv00s | Belgeselsemo: -
MTV HITS => Digiturk: mtvhits | Belgeselsemo: -
MTV LIVE => Digiturk: mtvlive | Belgeselsemo: -
MİNİKA GO => Digiturk: - | Belgeselsemo: minikago
MİNİKA ÇOCUK => Digiturk: - | Belgeselsemo: minikacocuk
MİNİKAGO => Digiturk: minikago | Belgeselsemo: -
NAT.GEO.WILD => Digiturk: natgeowild | Belgeselsemo: -
NATIONAL GEO. => Digiturk: nationalgeo | Belgeselsemo: -
NATIONAL GEOGRAPHIC HD => Digiturk: - | Belgeselsemo: nationalgeographichd
NATIONAL GEOGRAPHIC WILD HD => Digiturk: - | Belgeselsemo: nationalgeographicwildhd
NBA TV HD => Digiturk: - | Belgeselsemo: nbatvhd
NICK JR => Digiturk: nickjr | Belgeselsemo: -
NICKELODEON => Digiturk: - | Belgeselsemo: nickelodeon
NICKELODEON HD => Digiturk: nickelodeonhd | Belgeselsemo: -
NICKELODEON SD => Digiturk: nickelodeonsd | Belgeselsemo: -
NICKTOONS => Digiturk: - | Belgeselsemo: nicktoons
NOW => Digiturk: - | Belgeselsemo: now
NR1 DAMAR HD => Digiturk: - | Belgeselsemo: nr1damarhd
NTV => Digiturk: ntv | Belgeselsemo: -
NTV HD => Digiturk: - | Belgeselsemo: ntvhd
NUMBER1 TURK HD => Digiturk: - | Belgeselsemo: number1turkhd
NUMBER1 TV HD => Digiturk: - | Belgeselsemo: number1tvhd
Nick JR => Digiturk: - | Belgeselsemo: nickjr
ON6 => Digiturk: - | Belgeselsemo: on6
POWER TURK HD => Digiturk: - | Belgeselsemo: powerturkhd
POWER TV HD => Digiturk: - | Belgeselsemo: powertvhd
RAI1 => Digiturk: rai1 | Belgeselsemo: -
S SPORT => Digiturk: - | Belgeselsemo: ssport
S SPORT 2 => Digiturk: - | Belgeselsemo: ssport2
SEMERKAND HD => Digiturk: - | Belgeselsemo: semerkandhd
SHOW TV => Digiturk: showtv | Belgeselsemo: -
SHOW TV HD => Digiturk: - | Belgeselsemo: showtvhd
SKY NEWS ARABIA => Digiturk: - | Belgeselsemo: skynewsarabia
SPACETOON => Digiturk: - | Belgeselsemo: spacetoon
SPORTS TV HD => Digiturk: - | Belgeselsemo: sportstvhd
STAR TV => Digiturk: startv | Belgeselsemo: -
STAR TV HD => Digiturk: - | Belgeselsemo: startvhd
Sports TV => Digiturk: sportstv | Belgeselsemo: -
SÖZCÜ TV => Digiturk: sozcutv | Belgeselsemo: sozcutv
SİNEMA 1002 HD => Digiturk: - | Belgeselsemo: sinema1002hd
SİNEMA AKSİYON 2 HD => Digiturk: - | Belgeselsemo: sinemaaksiyon2hd
SİNEMA AİLE 2 HD => Digiturk: - | Belgeselsemo: sinemaaile2hd
SİNEMA AİLE HD => Digiturk: - | Belgeselsemo: sinemaailehd
SİNEMA KOMEDİ HD => Digiturk: - | Belgeselsemo: sinemakomedihd
SİNEMA TV 1001 HD => Digiturk: - | Belgeselsemo: sinematv1001hd
SİNEMA TV 2 HD => Digiturk: - | Belgeselsemo: sinematv2hd
SİNEMA TV AKSİYON HD => Digiturk: - | Belgeselsemo: sinematvaksiyonhd
SİNEMA TV HD => Digiturk: - | Belgeselsemo: sinematvhd
SİNEMA YERLİ 2 HD => Digiturk: - | Belgeselsemo: sinemayerli2hd
SİNEMA YERLİ HD => Digiturk: - | Belgeselsemo: sinemayerlihd
TARIH TV => Digiturk: - | Belgeselsemo: tarihtv
TARIM TV => Digiturk: - | Belgeselsemo: tarimtv
TARİH TV => Digiturk: tarihtv | Belgeselsemo: -
TELE 1 => Digiturk: tele1 | Belgeselsemo: -
TELE1 => Digiturk: - | Belgeselsemo: tele1
TEVE2 => Digiturk: teve2 | Belgeselsemo: -
TEVE2 HD => Digiturk: - | Belgeselsemo: teve2hd
TGRT HABER => Digiturk: tgrthaber | Belgeselsemo: -
TGRT HABER HD => Digiturk: - | Belgeselsemo: tgrthaberhd
TJK TV => Digiturk: tjktv | Belgeselsemo: -
TLC => Digiturk: tlc | Belgeselsemo: tlc
TMB TV => Digiturk: - | Belgeselsemo: tmbtv
TRT  ARABI => Digiturk: trtarabi | Belgeselsemo: -
TRT 1 => Digiturk: trt1 | Belgeselsemo: -
TRT 2 => Digiturk: trt2 | Belgeselsemo: -
TRT 2 HD => Digiturk: - | Belgeselsemo: trt2hd
TRT 3 => Digiturk: - | Belgeselsemo: trt3
TRT 3 / TRT SPOR => Digiturk: trt3trtspor | Belgeselsemo: -
TRT ARABI => Digiturk: - | Belgeselsemo: trtarabi
TRT AVAZ => Digiturk: trtavaz | Belgeselsemo: trtavaz
TRT BELGESEL => Digiturk: trtbelgesel | Belgeselsemo: -
TRT BELGESEL HD => Digiturk: - | Belgeselsemo: trtbelgeselhd
TRT DIYANET COCUK => Digiturk: - | Belgeselsemo: trtdiyanetcocuk
TRT EBA => Digiturk: - | Belgeselsemo: trteba
TRT EBA TV LİSE => Digiturk: trtebatvlise | Belgeselsemo: -
TRT EBA TV ORTAOKUL => Digiturk: trtebatvortaokul | Belgeselsemo: -
TRT EBA TV İLKOKUL => Digiturk: trtebatvilkokul | Belgeselsemo: -
TRT HABER => Digiturk: trthaber | Belgeselsemo: -
TRT HABER HD => Digiturk: - | Belgeselsemo: trthaberhd
TRT KURDI => Digiturk: trtkurdi | Belgeselsemo: -
TRT KURDİ => Digiturk: - | Belgeselsemo: trtkurdi
TRT MÜZİK => Digiturk: trtmuzik | Belgeselsemo: trtmuzik
TRT SPOR => Digiturk: trtspor | Belgeselsemo: -
TRT SPOR HD => Digiturk: - | Belgeselsemo: trtsporhd
TRT SPOR YILDIZ => Digiturk: trtsporyildiz | Belgeselsemo: trtsporyildiz
TRT TURK => Digiturk: trtturk | Belgeselsemo: -
TRT TÜRK => Digiturk: - | Belgeselsemo: trtturk
TRT WORLD => Digiturk: trtworld | Belgeselsemo: -
TRT World HD => Digiturk: - | Belgeselsemo: trtworldhd
TRT ÇOCUK => Digiturk: trtcocuk | Belgeselsemo: -
TRT ÇOCUK HD => Digiturk: - | Belgeselsemo: trtcocukhd
TRT1 HD => Digiturk: - | Belgeselsemo: trt1hd
TURKHABER => Digiturk: - | Belgeselsemo: turkhaber
TV 2020 => Digiturk: - | Belgeselsemo: tv2020
TV 4 => Digiturk: - | Belgeselsemo: tv4
TV+ Info => Digiturk: - | Belgeselsemo: tvinfo
TV100 => Digiturk: - | Belgeselsemo: tv100
TV5 => Digiturk: - | Belgeselsemo: tv5
TV5 MONDE => Digiturk: - | Belgeselsemo: tv5monde
TV5 MONDE EUROPE => Digiturk: tv5mondeeurope | Belgeselsemo: -
TV8 => Digiturk: tv8 | Belgeselsemo: -
TV8 HD => Digiturk: - | Belgeselsemo: tv8hd
TV8,5 => Digiturk: tv85 | Belgeselsemo: -
TV8,5 HD => Digiturk: - | Belgeselsemo: tv85hd
TVNET => Digiturk: tvnet | Belgeselsemo: -
TVNET HD => Digiturk: - | Belgeselsemo: tvnethd
TYT TÜRK => Digiturk: tytturk | Belgeselsemo: tytturk
TÜRKHABER TV => Digiturk: turkhabertv | Belgeselsemo: -
TİVİ6 => Digiturk: - | Belgeselsemo: tivi6
ULUSAL KANAL => Digiturk: - | Belgeselsemo: ulusalkanal
ULUSAL TV => Digiturk: ulusaltv | Belgeselsemo: -
VAV TV => Digiturk: vavtv | Belgeselsemo: vavtv
VIASAT EXPLORE => Digiturk: - | Belgeselsemo: viasatexplore
VIASAT HISTORY HD => Digiturk: - | Belgeselsemo: viasathistoryhd
YABAN TV => Digiturk: yabantv | Belgeselsemo: -
beIN => Digiturk: bein | Belgeselsemo: -
beIN GURME => Digiturk: beingurme | Belgeselsemo: -
beIN H&E => Digiturk: beinhe | Belgeselsemo: -
beIN MOVIES ACTION => Digiturk: beinmoviesaction | Belgeselsemo: -
beIN MOVIES FAMILY => Digiturk: beinmoviesfamily | Belgeselsemo: -
beIN MOVIES PREMIERE => Digiturk: beinmoviespremiere | Belgeselsemo: -
beIN MOVIES STARS => Digiturk: beinmoviesstars | Belgeselsemo: -
beIN MOVIES TURK => Digiturk: beinmoviesturk | Belgeselsemo: -
beIN SERIES => Digiturk: beinseries | Belgeselsemo: -
beIN SERIES 1 => Digiturk: beinseries1 | Belgeselsemo: -
beIN SERIES 2 => Digiturk: beinseries2 | Belgeselsemo: -
beIN SERIES 3 => Digiturk: beinseries3 | Belgeselsemo: -
beIN SERIES 4 => Digiturk: beinseries4 | Belgeselsemo: -
beIN SPORTS 1 => Digiturk: beinsports1 | Belgeselsemo: -
beIN SPORTS 2 => Digiturk: beinsports2 | Belgeselsemo: -
beIN SPORTS 3 => Digiturk: beinsports3 | Belgeselsemo: -
beIN SPORTS 4 => Digiturk: beinsports4 | Belgeselsemo: -
beIN SPORTS 5 => Digiturk: beinsports5 | Belgeselsemo: -
beIN SPORTS HABER => Digiturk: beinsportshaber | Belgeselsemo: -
beIN SPORTS MAX 1 => Digiturk: beinsportsmax1 | Belgeselsemo: -
beIN SPORTS MAX 2 => Digiturk: beinsportsmax2 | Belgeselsemo: -
beIN İZ => Digiturk: beiniz | Belgeselsemo: -
tabii TV => Digiturk: - | Belgeselsemo: tabiitv
tabii spor => Digiturk: - | Belgeselsemo: tabiispor
tv100 => Digiturk: tv100 | Belgeselsemo: -
ÇİFTÇİ TV => Digiturk: - | Belgeselsemo: ciftcitv
ÜLKE TV => Digiturk: ulketv | Belgeselsemo: -
ÜLKE TV HD => Digiturk: - | Belgeselsemo: ulketvhd
ŞÖMİNE PLUS => Digiturk: - | Belgeselsemo: somineplus
